111111111
100001111
100000011
101101001
100000001
111101001
100000001
120001111
111111111