1111111111111
1000111111111
1001111111111
1000000001111
1000111000001
1100000011011
1100111111011
1111111111011
1111111111011
1111111111011
1200000000011
1111111111111