11111111111
11000100001
10000001001
10101101001
10000001001
11000000001
10000111011
10100010011
10101010001
10000000101
12010010001
11111111111