11111111111
11111111011
11111100001
10000001001
10000011001
11110111111
11110111111
12000111111
11111111111