111111111111
111100001111
111101101111
111000001111
111000011111
111010000111
111000000111
111110011111
111110011111
100110011001
120010010001
110000000011
111000100111
111110011111
111111111111