11111111111111
11110011111111
11110011111111
11110000011111
11110111011111
11110111011111
11110111011111
10000111011101
10110111011101
10110111000001
10110111001101
10110111101101
12111111111101
11111111111111