111111111
100000001
101110101
100000101
111110001
111100111
111100011
110000011
110000001
120000001
111111111