11111111
10011111
11011111
11000011
11011011
10000011
12011011
11111111