11111111111
10000111111
10110000011
10111111011
10101111011
10101000001
10100001101
10110000101
10100000101
10100001101
10111101101
12000000001
11111100011
11111111111