1111111
1001111
1000011
1101011
1101011
1101001
1201001
1111111