1111111111111
1111111110111
1111111110111
1111110000111
1000000110011
1011110000011
1011110010011
1011111010011
1011111000111
1011111011111
1211111111111
1111111111111