111111111111111
100001111111001
101100000000001
100110111011111
110110100000011
100000000011011
101110111011011
100100000000011
110100111111011
100000111011011
101000110011011
101000100000011
101011110111001
120011110000001
111111111111111