111111111111
111001100111
110000000011
100001100001
100011110001
120111111001
111111111111