111111111
100000001
100111011
100000001
110000001
100000011
100000001
100111001
120000001
111111111