111111111111
111111000001
111111011101
100000011101
110111110101
110001110101
111101110101
111101000001
100001010111
101110000111
101110001111
101110101111
121110001111
111111111111