111111111111
100000111111
101110001111
101000000011
101010000011
101011101111
101000001101
101111101101
101000000001
101011101001
121000001001
111111111111