111111111
100010001
100000001
101110001
100000011
111111001
100011001
121000001
111111111