11111111111
11111111111
10010111111
10000011111
10110011111
10110000011
10111001011
10111100011
12111111111
11111111111