1111111111111
1111111111111
1111111110001
1100000000001
1101111110101
1101000000101
1001011111101
1001000001101
1001111101101
1001111101101
1211111111111
1111111111111