111111111111
100000001001
100000000001
101111101101
101111101101
110000000101
111111110101
111111110101
111111111101
120000000001
111111111111