11111111
11100001
11101101
11101101
11101001
11001111
12011111
11111111