1111111
1000101
1010101
1000001
1110101
1200101
1111111