111111
100001
101101
101101
120001
111111