1111111
1000001
1011101
1010101
1010101
1210001
1111111