111111111
100000001
101111101
101111101
100011101
101011101
101011101
120000001
111111111