111111111
110000111
100001111
101001111
101001111
101001111
101000001
121000001
111111111