111111111
110000111
100110111
101110101
100000001
111110001
111111011
120000011
111111111