111111111
110000001
110101111
110101111
100001111
100111111
100110001
120000001
111111111