111111111
111111111
100000001
111100101
111000001
111000111
111000111
120000111
111111111